111111111111111111111111
1C0100000100000000000001
10101000010000C000010101
100000000000000000111101
100000000100000000000101
100000000100000000000001
100000000000000000000001
100000000000000000000001
10000C00000000P0000E0001
100000000000000000010111
100000000000000000010C01
111111111111111111111111
