111111111111111111111111
10P0000001000C0000100001
10000000010000000000E001
100000000000000000111111
1000C0000100000000000001
100000000100000000000001
100000000000000000000001
100000000000000000C00001
1000000C0000000000000001
1C0000000000000000000001
100000000000000000000001
111111111111111111111111