11111111111111111111111111111111111
110C1000000011100001000000000011111
1000100000001110000100C000000000011
10001000000011000001000000000000001
10001001100000000001000001111110001
10001000110000000000000011000000001
100010000110000C00000001100000000C1
10000000001000000000000100000000001
10000000000000001111000100000010001
10000000000000001000000000000000001
1000P001100100000000000000000000001
10000000000000000E0000010011000C001
10000000000000000010000000000000001
10001000000100011110000000000000001
10000000000100C00000000010000000001
10000000001100000000000011000010001
10C000000110000000000C00011000100C1
10000000011000000000000001100010001
10000000000000010000011000000010001
11000000C00000010000111000000010001
11111000000000010000111000000010011
11111111111111111111111111111111111